#######################
# @    #   ###### .   #
#   $    . ######     #
#   $  #   ######     #
#      #              #
#      #              #
#######################