#######
#     #####################################################################################
# .$.                                                                                     #
# $ $ .                                                                                   #
# .$. #####################################################################################
# $.$ #
#  @  #
#######
