###################
#                 #
#                 #
#           #     #
#           #     #
#           #$$   #
#   #########..   #
#   @             #
###################
