############################################################
#                                                  ####    #
#                                                          #
#                                                #         #
#                                                #         #
#                                                #         #
#                                                #         #
#                                                #         #
#                                                #         #
#                                                #         #
#                                                #         #
#  @ $                                             #  .#   #
#                                                          #
############################################################
