#############
#.#.#.#.#.#.#
# # # # # # #
#+#+#+#+#+#+#
#$#$#$#$#$#$#
#+#+#+#+#+#+#
#*#*#*#*#*#*#
#+#+#+#+#+#+#
#*#*#*#*#*#*#
#+#+#+#+#+#+#
#*#*#*#*#*#*#
# @         #
#############