###########################################################
#     # # #  # #  #     #      ##     #     #      ########    
# ### # # #  # #  # ### #  #### # ### ### ### #############
# # # # # #  # #  #.# # #  #    # # # # # # # #          #
# ### # # #  # #  #$# # #  ##   # ### # # # # #          #
# # # ### #### #### ### #  ######     # # ### # ###########          
# # #                 $.          ###              ########
# # ############################### #######################                                
# # ####     #######   #######     ######      #####      #           
#        #####  . $  #       #####        ####       ######     
###### ################ ###################################                
#   .      $     @                         ################                 
##################### ####################                #                 
#                  #                     # ################               
#                  #####################                  #               
#                  #                     # ################
#                  #######################                #                
#                  #                       ################               
#                  #   .      $          #                #
#                  #                     # ################
######             #                     #                #
#    ################################## ###################
#    #                  #       #######                  ##
###########################################################
#                                                        ##
###########################################################