#####################################
#        #                          #
#        #                          #
#        #      ###############     #
#  ####  #      #             #     #
#   #    #      #             #     #
#   #    #                  ..#     #
#   #    #      #             #     #
#   #    #      #             #     #
#   #    ######################     #
#   #    #             #            #
#   #    #    @        #            #
# $ #    #    #######  #            #
#  ##    ###  #        ########     #
# $ #         #                     #
#   #         #                     #
#####################################

