#######################
#                     #
#  .              $   #
#  .  @           $  ##
#  .              $  ##
#                     #
#######################
