##############################################################################################################
#                                                                                                    ####    #
#                                                                                                            #
#                                                                                                  #         #
#                                                                                                  #         #
#                                                                                                  #         #
#                                                                                                  #         #
#                                                                                                  #         #
#                                                                                                  #         #
#                                                                                                  #         #
#                                                                                                  #         #
#  @ $                                                                                               #  .#   #
#                                                                                                            #
##############################################################################################################
