#########
#   #   #
#   #   #
#   # . #
#@$$$.  #
#   # . # 
#########
