#######
#     #
# .$. #
# $.$ #
# .@. #
# $.$ #
#  $  #
#######
