############################################################
#                                                          #
#                                                          #
#                                         ############     #
#   @                           $         #  .             #
#                             $ $         #  .             #
#   #######################################                #
#                              .                           #
############################################################
