   #####
  ##   #
###    #
#    # #
#@$  # #
#  ### #
####   #
   # . #
   #   ##
    #   #
    #   #
    #####