############################################################
#                                                          #
#                                                          #
#                                         ############     #
#   @                           $         #  .             #
#                               $         #  .             #
#   #######################################                #
#                                                          #
############################################################
