#############
#@          #
#   $  $    #
#   ####    #
#   ....    #
#   ####    #
#   $  $    #
#           #
#           #
#############

