########
#@    .#
# $    #
#      #
########
