###################
#                 #
#                 #
#           #     #
#           #..   #
#  @        #$$   #
#   #########     #
#                 #
###################
