                             
            
                                   ##########
                    +++++++++++############
                                      
                             
     ###################################         
     # $++++++++++++++++++++++++++++++.#                   
     #@################# ###############                           
     ####              # #                             
                       # #                            
                       ###                            