############################################################
#                                          .               #
#         .                                $               #
#         $                                                #
#                                                          #
#                                                          #
#   @$                                              .      #
#                                                          #
############################################################
